WEEEEEEEEWEEEEEEEEEEEEEEHEEEEIEEEEEHEEEEEIEEWEEWEWEEEEEEEIEEEEEEEEEEEEEEEEEEEHEEEEEHEEEEEHEEEEEEWEEE
EEEEEEEEEEEEEEEHEEIEEEEEEEEEEEEHEEEEEEEEEEEEEEEEEIWEEEEEEEIEEEEEEEEEEEEEEEEEEEEEEEEHEEEEEEHEEEEEEEEE
HEEIEEEEEEEEEWEEEEEEEEEEEEEEEEEHEWEEEEEWEEEEEEIEEEEEEEEEEEEEEEEEEEEEEHEEEEEEEEEEEEEEEEEEEHEEEEIEEEEE
EEEIEEEEEEEHEEEEEEEEEEEEEEEEEEEIEEEPEEEEEEEWEEEEEEEEEIEEIEEEEEEEEEEEEEEEEEEEEIEEEEEIEEEEEEEEEEEEEEEE
EIEEEEEEEEWEEEEEEEEEEEEEEEEEEEEEEEEEEEEEEEEEEEHEHEEEEEEEWEEIEEEEEEEEEEEEEHEEEEEEEEEEEIEEEEEHEEEEEEEE
WEEEEEEEEEEEEEEEEEEEEEEEEEEEEEEEEEEEEEEEEEEEEEEEEEWEEEEEEEEEIEEEEEEEEEEEEEEEEEWEEEEIEEEEEEEEEEEEWEEE
EEEEEEEEEEEEEEEEEEEEIEEEIEEIEEEEEEEEEEEEEEPEEEEEEEEEEEEEEEEEEEEEIEEEEEEEEEEEEEIEEEEEEHEEEEEIEHEEEEEE
EEEEEEEEEEEEEEEEEEEEIEEHEEEEEWEEEEEEEEEEEEEEEEEEEEHEEEEEEEEEEEEEEEEEWEEEEEEEWWEEEEEEEEEEEWEEEHEEEEEE
EEEEEWWEEEEEEEEEEEEEEEWEEEEEEEEHEEEEEEEEEEEEEEEEEEEEHEEEEEEEEHEEEEEEEEEEEEEEEEEWEEEEEEEEEEEEEEEEEEEE
EEEEEEEIEEEEEEEEEEEEHEEEEEEHEHEEEEEEEEEEIEEEEEEEWEEEEEEEEEEEEEEEEEEEEEEEEEEEEEEEEEEEWEEEEEEEEEEEEEEE
EEEEEEEEEEEEEEEEEEEEHEEEEEEEHEEEEEEEEEEEEWEEEEEEEEEEWEEEEEEEEEEEEEEEEEEEEEEEEEEEEEEEIEEIEEEEEEEEEEEE
EIEEEEWEEEEEEEEEEEEEEEEEEEEEWEEEEEEEEEEEEEEEEEEEHEEEEEEEEEEEEEWEEEEEEWIEEEEEEEEEEEEEEEEEEEEEEEEEEEEE
EEWEEHEWEEEEEEEEEEEEEEEEEEEEEEEEEEEEEEEEEEEEHEEEEEEEEEEEEEEEEEEEEEEEEEEEEEEEEEEEEEEHEEEEEEEEEEEHEEEE
EEEHIEEEEEEEEEHEEEEEEEEWEEEEEEEEEEEEEEEEEEEEEEEIEWEEEEEEEEEEEWEEEEEHEEEEEEEEHEEEEEEEIEEEEEEEEEEEEEEE
EEEEEEEEEEEWEEEEEEEEEEEEEEEEEEEEEEWEEEEEEEEEEEEEWEEEWEEEEEEEEEEEEEEEEEEEEEEEEEEEEEIWEEEEEEEEEEEEHIEE
EEEEEWEEEEEEEEEEEEEEEEEEEEEEEEIWEEEEIEEEEEEEEEEEEEEEEEEEEEEEEEEEEEEEEEEEEEEEEEIEEEEEEEEEEEEEEEEEEEEE
EEEEEEEEEWEEEEEEEEEEEEEEEEEEEEEEEEEEEEEEEEEEEWEEEWEEEEEEEEEEEEEEEEEEEEEEEWEEEEEEIEEEEEEEEEEEIEEEEEEE
EEEEEEEEHEEEEWEEEEEEEEEEEEEEEEHEEEHEEEWEIEEEEEEEEEEEEEEEEEEEEIEEEHEEEEEEEEEEEEEEEIEEEEEEEEIEEEEEEEEE
EEEEEEEEEEHEEEEEEEEEEEEEGEEEWEIEEEEEEHEEEEEEEEEEEEEHEEWEEEEEIEEEEWEEEEEEEEEIEEEHEEEEEEEEEEEEEEEEWEIE
IEEEEHEEEIEEEEEEEEEIEEIWEEEEEEEEEEEEEEEEEEEEEEEEEEEEEEEIEEEEEEEEEEEEEEEEEEEEEWEWEPEEEIEEEEEEEHEEEEEH
HIEEEEEEEEEEEEEEEEEEEEEEEUUUEEEEUUUHEEEEEEEHEEEEEEEEEEEEEEEEEEEEHEEEEEEEEEEEEEIEEEEEEEEEEEEEEEEEEEEH
EEEEEEEEEEEEEEWEEEEEHEEEEUUUEEEEUUUEEIEUUUEEEWEEEHEEEHEEEEEEEEEEEEEEEEEEEEEWEEEEEEEEEHEHEEWEEEEEEEEE
WEEEWEEEEEEHEEEEEEEEHEEEEUUUEHEEUUUEEEEUUUEEEEEEEEEEEEEEWEWEEEEEEEEEEEEEEEEEEEEEEEEIIEEEEEEEEEEEHEEE
EEEWEEEWEEIEEEEEEEEWEEEEEEEEHIEEEEEEEEEUUUEEEEEWEEEEEEEEEEEEEEEEEEEEEEEEEEWEEEEEEEHEEEEEEEEEEEEEEHEE
EEEEEEEEIHEEEEEEEEEUUUEEEEEEPIEEEEIEEEEEEEEEEWEEEEEEEEEEEEEEEEEEEEEEEEEEEEEEEEEEEEEEEEEEEEEEEEEEEWEI
IIEEEWEEEHEEEEEHEEEUUUEEEEEEEEHEEEEEEEEEEEEEEEEEEEEEEEEEEEEEEEEEEEEEEEEEEHEEEEHEEWEEEWEHEIEWEEEEEEWE
EEEEEEEEEEEEEEEEEEEUUUEEEEEEEEEEEEEEEEEEEEEEEEHEEEEEEEEEEEEEEEEEWEEHEEEEEEEEEEEEEEEEWEHEEEEEEEEEHEEE
EEEEEEEWEEEEEEEEEEEEEEEHEEEEEEEEEEEEEEUUUEEEEEEEWEEHEEEHEEEEEEEEEEEEEEEEEEEEEEEEEEEEEEEEEEEEEEEEEEEE
EEEEEIEEEEEEEEEEEEEEEEEEEEEWEEEEEEEEEEUUUEEEEEEEEPEEEEHEEEEEEEEEEEEEEEEEWEEIEEEEEEEEEEEEWEEEEEEEEEEE
EWIIWEHEEEEEEEEEEEEEEEEEEIEEEEEEEEEEEEUUUIEEEEEEEHEEEEEEHEEEEEEEEEEEEEEEEIEEEEEEIEEEEEEEEEEEEEIEWEIE
EEEEEEEEEEEEEEEEEEEEWEEEEEEEEEHEEHEIEEWEEEEEEEEEEEEEEHEEHEEEEEEEEEEEEEEWEEEEEEEEEIEEEEEEEEEEEEEEEEEH
EEHEEEEEEEEEEEEEEEUUUEEEEEEEEEEEEEEEEEEEEEEEEEEEEEEEEEEEEEEEEEEEEEEEEEEEEEWEEEEPEEPEEHEEEEEEEEEEEEEE
EEEEEEEEEEEEEEEEWEUUUEEEHEEEEEEEEEEUUUHEEEEWEEWEEHEEWEEWEEEIEEEIEEEEIEEGEEHEEEEEEEEEEEEEEEEEEEEEEEEE
EEEEEEEEEEEEEEEEWEUUUEEEEHEEEEIEEEEUUUEEEEEWWEEEEEEEEEEEEEEEEEEEEEEEEEEEEEIEEEEEEEEIEEEIEEEHEEEEEEEE
EEEEEEIEEEEEEEEEEEEEEUUUEEWEEEEIEHEUUUHEHEEEEEIWEEEEEHEEEEEEEEEEEEEEEEEEEEEEEEEEEWEEEEEEWEEEEEEEEEEE
IEEEEEEEEEEEEEEEEEEEEUUUEEEEEEEEEEHEEWEEEEEEEEEEIEEEEEEEEEEEEEEEEEEEEEEWEEEEEEHEEEEEEIWEEEEEEEEEEEEE
EEIEEEEEEEEEEEEEWEEEEUUUHEWEIEEEEEEEEEEEEEEEEEEEEEEEEEEEEEEEEEEEEEEEEWEEEEEHEIEEEEEEWEEEEEEEEEEEEEEE
EEEEEEEEEEEEIEEHEEIEEGEEEEEEEEEEHEEEEEEEEEEEEEEEEEEEEEEEEEIEEEEEEEEEEEEEEEEEEEEEEEEEEEEEHEEEEEEEHEEE
EEEHEEEEEEEEWWEEEEEEEEEEEEUUUEHEEEEEEHEEEEIEEEEEEEEEEHEEEIHEEEEEEEEEEEEEEEEEEEWEEEEEIEWEEEEIEEEEEEEE
EEEEEEEEEEEEWEEWEEEEGEEEEEUUUEEEEEEEEEEEEHEEEEEEEEIEEEEHEEEEEEIEEEEEEEEEEEEEEEEEEIEEEEEEEEEEIEEEEEEE
EEEHEEEEEEEEEEEEEEEEEIEEEEUUUEEUUUEEEEEEEEEEEEEEEEEEEEEEEEEEEEEEEEEEEEEEEEEEEEEEEEEEEEEEEEEEEEEEEEEE
EEEEEEEEEEEEEEEEEEWEWEEEEHEEEEIUUUEIEHEEEEEEEEEEEWHEEEEEEEEEEEEEEEEEEEEEWEIEEEEEEHEEEEEEEEEEEIEEEEII
EEEEEEEEEEGEEEEEEEIEEEEEEEEEEEEUUUEEEEEEEEEWEEEEEEEEEEEEEEEEHEEEEEEWEEHEEEEEEEEEIEIEEEEEEEEEEEEEEEEE
WEIEEEEEEEEEEEEEEHEEEEEEIEEWEEEEEEEEEIEEEEEEEEEEEEEEEEEEIHEEEEEEEEEEEWIEEEHEEEEIEEEEEEEEEEEEEEPEEEWE
EEEEEEEEEEEEEEEEEEEEEEHEEEEEEEEEEEEEEEEEEEEIEEEEEEWEEEEHEEEEEEEEEEEEEEEEEEEEEEEEEEEEEEEWEEEIEEEEHWEW
HEEHEEEEEEEEEPEEEWEWEEEEEEEEEEEEEEWEEEEEEEEEEEEEEEEEEEEEEEEEEEEEEEEHEEEEEEIPEEEEIEWEEEEEEEEEEEEEEEEE
EEEEEHEEEEEEEEEEEEEEHEEEEEEWEEEEEEIEEEEEEEEEEEEEEEEEEEEHEEEEEEEEEEEEEEEEEEEEEEEEEEEEEEEEEEEEEEEEEEEE
EEGEIEEEEEEEEEEEEEEIEEEEEEEEEEWEIEEEHEIEEEEEEEEEEEWEEEEEEEEEEEEEEEEEEEEEEEEEEEEEEEEEEEEWEEEEEEEEEIWE
EEEEEEEEEIEEEEEEEEEEEEEEEEEHEEWHEHEEEEEEHEEEEEEEEEEEEEEEEEEEEEEEEEIEEEEEEEEEEEEEEEEEEEEHHIEWEEEEWEEE
EEEEEEEEIEEEEEEIEEEEEEIWEEEEHEEEEEGEWEEEEEEEEEWEEEEIEEEIEEEEIWEEHEEEEEEEEEEEEWEEHEEEEEEEEEEHEEEEEEEE
EEEEEEEEEEEEEEIEWHEEWEEEEWWEEEEEEEEEHEEEEEEEEWEEEEEEEEEEEEEEEEEEEEEEEEEEEEEEEEEEHEEEEEEHEEEEEHEEPEEE
EEEEEEEEEEEEEEEIEEEEEHWEEWEEEEEEEEEEEEEEEEEEEEEEEEEEEEEEEEEEEWEEHHEEEEEEEEEEEEEEEEEEEEEEEEEEEEEEEEWE
EEWEEEHEEEEIEEEEEEEEEEEEEEEIEEEEIEEEEEEEEEHEEEEEEEEEEEEEWEGEEEEEHEEEEEEWEEEEEEWEEEEEWEEEEEEIEWEEIEEE
EEEEEEEEEIEEEEEEEEEEEEEEEWEEEEEEEWEEEEEEEEEEWEEEEEEEEEEWEEHEEEEEEEEEEWEEEEEEEEEEEEWEEIEHEEEEIEEEEEEE
EEEEEEEEIEEEEEEEPEEEEEEEEPEEEEEEEEEEEEEEEEEEEEEEEIEEEEEEEEEEEEEEEEEEEEEEEHEEIEEEEEEEEEEIEEEEHEEEEEEE
EIEEEEEEEEEEEEEEEEEEEIEHEEWEEEEEEEEEEHEWEHEEIEEEEEEEEEIIEEEEEEEEEEEEEEEEEEEIEEEEEEEEEEEEEEEEEEEEEEIE
EEEEEEEEEEEEEEEEEEEEEEEEEEEEEEEEEEEEEEEEEEEEEEEEEEEEEEEEEIEEEEWEEIEEEEEEEEEEEEEEEEEEEEEEEEEEEEEEEEEI
EEEEHEEEEEEEEEEEEEEEEEEEEEEEEEEEEEEEEEWEEEEEEEEEEEEEWEEEEEEEGEEEEEEEEEEJJJEEEEEEEEEEEEEEEEEEEEEEEEEE
EEEEEEEEEEEEEEIHEEEEEEIEEEEIEEEEEEEEEEEIIEEEEEEHEEEEEEEEHWEEEEIEEEEEEEEJJJHEEEEPEEEEEEEEIEEEEEWEEEEE
EEHEEEEEEEEEEEEEEEEEIEEEEEIEEEEEEEEEEEEEHEWEEEEEEEEEEEEEEEEEEEHEEWJJJEIJJJEEEEEEEEEEEEEEEEEEEEEEEEEE
EEEEEEEIEEEEEEHEEEEEEEEEEWEEEEEEEEEEEEEIEEEEEEEGEEEEEEEEEEEEEEEEEEJJJEEEEEEEEWEEEEEEEEEEEEEEEEEEEEEE
EEEWEEEEEEEEEEEEEEEEEEEEEEEEEEEEEEEEEEEEEEEEEEEEEEWEEEHEWEEEEEEIEEJJJEIEEEEHHEEEEEEEEEEEEEEEEEIEHEEE
EEEEEEEEPEEEEIEEEEEEIEEEEEEEEEEEEEEEEEEEEEEWEEEEEEEEEEEEEEEEEEEWEEEEEEEHEEEEEEEEEEEEEEEEEEEEEEEEEEEE
EEEEEEEEEEWEEEEEEEEEEEEEEEEEEEIEEEEEHEEEEEEHEEEEEEHEEEWEEEEEEVEEEEEEEHEEEEEEEJJJEEEEEEEEEEWEEIEEEEEE
EEEEEWEEEEEEEEWEEEWEEEEEEEIEEEEEEWEEEEEEIEEEWEEEEEWEEEEEEEJJJIEEEEEEHEEEVEEEEJJJEEEEEWEEEEHEEEEEEEEE
EEEEEHEEHEEHEEEWEEEEEEEEEEEEEEEEEEEEEEEIEEEEEEEEEEEEEEEEEEJJJEEEEEVEEEEEEEHEEJJJEEIEEEEEEEEWEEEEEEWI
EEEEEEEEEEEEEEEEIWEEEEHEEIEEEEEEEEEEEEEEEEEWEEEEIEEEHEEEEEJJJEEEEEIEEEEEEEEEEEEEEEEEHEEEEEEEEHEEEEEE
EEEEEEEIEEEEEEEEEEEEWEEEEEEEEEHHEEEHEEEEEEEHEEEEEEEEEEEEEEEEEIEEEEEEEEEIEEEEEEEIEJJJEHIEEEEIEWEEEEEE
EEEEEEEWHEEEEEEIEEEEEEEEEIHEEEEEEEEEEEIEEEEEEHHEEEEEHEEEIJJJEEEEIEEEEEEWEEEEEEEEEJJJIEEEEEEEEEEEEEEE
HEEIEEEEEEEEEEIEEWIEEEEEEEHEEEEEEEWEHEEEEEEEEEWEEEHEEEEEEJJJEWEHEEEEEEEEHEEEEEEEEJJJEEEEEIEEEEEEEEEE
EEEEEEEEEEEWEEEEEWEPEEEEEEEEWEEEWEEEEEEEGEEHEEEEEEEEEEEEEJJJEEEEEEEEEEVEEEIVEEEEEEEEEEEEEEEEEEEHEEEE
EEEEEEEEEWEEEEEEEEEEEEEEIEEEEEEEEEEIEEEEEEEEEEEEEEEEHEEEEEEEEEEEEEEHEEEEEEEEEEEEEEEEEEEEEHEEEEEEEHEE
EEEEEEEEEEHEEEEEEEEEEEEEEEEEEEEEEEEGWEEEEEEEEEEEEEEEEEEEIEEIEEEEEEEHEEIVEEEEEEEEEWEEEEEEEEEIEEIEEEEE
EEEEEEEEEEHEEEEWEEEEEEEEEEEEEEEEEEEEEEEWEEEEEEEEEEEEEWEEEEHJJJEEEEEVEEEWEEEEEEVIEEEEEHEEEEHEEEEEIEEE
EEEEEEEEEEEEEEEEEEEEEEEIEEEEEEEEEEEEEEEEEEEEEEEEEEEEEIEEEEEJJJEEEEEEEVEEEEEEEEEEEEEEEEEWEEEEEEEEEEEP
EHEEEEEEEWIEEEEEEEEEEEEEEEEEEEEEEEEEEEEEEEEEEEEEEWEEEEEEEHEJJJIEEEEEEEEVEEEJJJEEEEEEEEEEEHEGEEEEEEEE
EEEEEEEEEEEWHEEEEEEEEEEEEEEEHEEEEEEEEWEEEEHEEEEEEEEEEEEEEIIEEEIEEEEEEEEEEEEJJJEEEEEEEEWEEEEEEEEEEEEE
EEEEEEEEEEEEEEEGEEEEEEEEEEEEEEIEEEEEEEEEHHEEEEEEEEEEEEEEEEEEEEEEEEEEEIEEEEEJJJEWEEEEEEHEEEEWEEEEEEEE
EEEEEEEEEEEEEEEEHEEEEWEEHEEEEEEEEEEEEEEEEEEEEEIEEEEEEEEWEEEEEEEEEEEEEEEEEJJJEEEEEEEEEEEEEEEEEIEEEEEE
EEEEEEEEEEIEEEEEEEEEEEEEEEEEEEEEEEEEEEEHIHEEEEEEEEEHEEEEEEEEEEWEEJJJEEEEEJJJEEEEWGEEEEEEEEWEEEEEEEEE
EEEEEEEWEEEEEEEEEEEEEHEEEEEEEEEEEEEEEEEEEEEEEEEEEEEEEEEEEEEEEEEEEJJJEEEEEJJJEIIEEEEEEEEEEEEEEEEPEEEE
EEEEEEEEEEEEEEEEEEIEEEEPEEEEEIWEEEEEEEEEEEEEEEEEEEEEEGEEEEEEEEEEEJJJEEEEEEEEEEEEWEEEEEEEEEEEEEEEEIEE
EEEEIIEEEEEEEEEEEEEEEEEEEEEEEEEEWEEEEEEEEEEEEEWEEEEEEEEEEEEEEEEEEEEEEEEEEWEEEEHEEEEEEHEEEEEEEEEEEEEH
EEEEEEEIEWEEEEEEEEEEEEWEHEEEEEEEEEEEEEEEEEEEEEEEEEHEEEEEEHEEEEWEEWEEEEEEEEEEIEEEHEEEEEEEIEEHEWEEEEEE
EEEEEEEEEEEEEEEEEEEWEHEEEEIEEEEEEEWEEEEEIEEEEEEEEEEEEEEEEEEEEEEEEWEEEEEEEHEWEWEEEEEEEEEEEEEHEHEEEEEE
EEEEEHEEEEEEEEEEEEWHEEEHEEEIEEEEEEEHEEEEWEEEEEEHEHEEEEEEEEEEEEEEEEEEEWEEEEEEEEEEWEEEEEEEEEEEIEEEEEEE
IEEEEEWWEIEEEEEEEEEEEEEEEEEIWEEEEEEEEEEGHEEEEEEEEEEHEEEEEEEIHEEEEHEEEHEEEWEEEEEHEEEEEEEEEEEEEEIEEEEE
EEHEEWEEEEEEEEEEEEEEEEEEEEEEEEEEIEEEEEEEEEEEEEEEEEEEEEEEIEEEEEEGEEEEEEEEEIEEEEEEEEWEEEEEEEEEEEEEEEEE
EEEEEEEEEEEEEEEEEHEEEEIHEEEEEEEEEEEEEEEEEEEEEEEHEEEEEEEHEIEEEEEEEEEHEEEEEHEEEEEEEHEEEEWEEEEEEHHEEEEE
EEEEEEEEEEEEEEEEEEEEEEEEEEEEEEWEEEEHEEEEEEEEEEEEEEIWEEIEEEEEEEEEHEEEEEEEEEEEEEEEEEEEEEEEEEEEEEHEIEEE
IEHEEEEEEEEEEEEEEWHWEEEEEIEEEHEEEIEEIEEEEEEEEEEEEEEEEEHEEEHEEEEEWEEEEEWHEEEEEEEEEEEEEEEEEEEHEEEEEEIE
EEEEEEEEEEEEEEEEEEEEEEEEEEEEEEEEEEEEEEEEEEEEEEEEEEEEHEEIEEEEEEEEEEEEIEEEEIWEEEEEEEEEEEEIEEEEEIEIEEEE
EEHIEEEHEEEIEEEEEEEEEEEHEIEEEEEEEEEEEEEEEEGHEWEEEEEEEEEEEEEEEEEEEEEEEEEEEEEEEEEEEEEEEEEEEEEEEEEWIEEE
EEEEEEEEEEEEEEEEEEEEEEEEEEEEEEEEEEEEEEEEEEEEEHEEEEEWEEEEEEEEEEEEEEEEEEEEEEEEEEEEEEEWEEEEEEEIEEEEEEEE
EEWEEEWEEEWEEEEEEEEEHEEEEEEHHEEEEEEEEEEEEEHEEEEEEEEIIEEEEEEEEEEEEEEEEEEEEWEEEEEEEEEHEEEEEWEEEEEEEEEE
EEEEEEIEEEEEEEEEEWEEEEEEEEEEWEEEEEEEEEEEEEEEEWEEEEEEIEEEEEEEEEEEEEEEEEEEEEEEEEEEEEEEEEEEPEEEEEEEEEEE
EEEHEEEEEEWIWEEEEEHEEEEEEHEEEEIEWEEEEEEEEEEEEEEEEEHEEEEEEEEHEEEEEEHEEEEEHEEEEEEEEEEHEHEEEWEEEEWEEEEE
EEEEEEEEEEEEEEEIEEEEEIIEEEEEEWEEEEEEEEEEEEEHEEEEEEEEEEEEEEEEEEEWEEEEEIEEEEEIEEEEEEEEIEEEEEEHWWEEEEEE
EEEEWEEEEEEEEEEEEEEWEEEEEEEEEEEHIEEWEEEEEEEEEEEEEEEEIIEHEEEIEWEEEEEEEEEEEEEEEEEEEEEEEEWEEIEEEEIEEEHE
EEEEEEEEEEEWWEEEEEEEEEEEEEEEWEEEEEEEIEEEWEEEEEWEEEEEEEEGEEEEEEEEEEWEEEEEEWEEEEEEIEEEEEEHEEEHEEEEEEEH
